9
-2, -5, 0
2, 2, 2, 0
4
0, 0, 0, 0, 0, 0, 0, 0, 0, 0, 0, 0, 0, 0, 0
0, 1, 1, 1, 1, 1, 1, 1, 1, 1, 1, 1, 1, 1, 0
0, 1, 0, 0, 0, 1, 0, 0, 0, 1, 0, 0, 0, 1, 0
0, 1, 0, 0, 1, 0, 0, 2, 0, 0, 1, 0, 0, 1, 0
0, 1, 0, 0, 0, 0, 0, 0, 0, 0, 0, 0, 0, 1, 0
0, 1, 1, 1, 1, 1, 0, 0, 0, 1, 1, 1, 1, 1, 0
0, 0, 0, 0, 0, 0, 0, 0, 0, 0, 0, 0, 0, 0, 0
-2, -4, 0
2, 2, 3, 0
4
0, 0, 0, 0, 0, 7, 0, 0, 0, 8, 0, 0, 0, 0, 0
0, 0, 0, 0, 0, 7, 0, 0, 0, 8, 0, 0, 0, 0, 0
0, 0, 0, 0, 0, 7, 0, 0, 0, 8, 0, 0, 0, 0, 0
0, 0, 4, 0, 0, 1, 1, 1, 1, 1, 0, 0, 3, 0, 0
0, 0, 0, 0, 0, 8, 0, 0, 0, 7, 0, 0, 0, 0, 0
0, 0, 0, 0, 0, 8, 0, 0, 0, 7, 0, 0, 0, 0, 0
0, 0, 0, 0, 0, 8, 0, 0, 0, 7, 0, 0, 0, 0, 0
-2, -3, 0
2, 2, 0, 0
4
0, 0, 0, 0, 0, 8, 0, 0, 0, 7, 0, 0, 0, 0, 0
0, 0, 0, 0, 0, 8, 0, 0, 0, 7, 0, 0, 0, 0, 0
0, 0, 0, 0, 0, 8, 0, 0, 0, 7, 0, 0, 0, 0, 0
8, 8, 8, 8, 8, 1, 6, 6, 6, 1, 8, 8, 8, 8, 8
0, 0, 0, 0, 0, 8, 0, 0, 0, 7, 0, 0, 0, 0, 0
0, 0, 0, 0, 0, 8, 0, 0, 0, 7, 0, 0, 0, 0, 0
0, 0, 0, 0, 0, 8, 0, 0, 0, 7, 0, 0, 0, 0, 0
-2, -2, 0
2, 0, 0, 2
4
0, 0, 0, 0, 0, 0, 0, 0, 0, 7, 0, 0, 0, 0, 0
0, 1, 7, 7, 7, 1, 1, 1, 1, 1, 8, 8, 8, 8, 8
0, 8, 0, 0, 0, 0, 0, 0, 0, 7, 0, 0, 1, 0, 0
0, 8, 0, 0, 0, 0, 0, 0, 0, 7, 0, 0, 1, 0, 0
0, 8, 0, 0, 0, 0, 0, 0, 0, 7, 0, 0, 1, 0, 0
7, 1, 1, 1, 1, 1, 8, 8, 8, 1, 7, 7, 7, 7, 7
0, 0, 3, 0, 0, 8, 0, 0, 0, 8, 0, 0, 0, 0, 0
-1, -2, 0
4, 2, 2, 0
4
0, 0, 0, 0, 0, 0, 0, 0, 0, 0, 0, 0, 0, 0, 0
8, 8, 8, 0, 0, 0, 0, 0, 0, 0, 0, 0, 0, 0, 0
0, 0, 8, 0, 0, 0, 0, 0, 0, 0, 0, 0, 0, 0, 0
0, 0, 1, 0, 0, 0, 0, 3, 0, 0, 0, 0, 0, 0, 0
0, 0, 7, 0, 0, 0, 0, 0, 0, 0, 0, 0, 0, 0, 0
7, 7, 7, 0, 0, 0, 0, 0, 0, 0, 0, 0, 0, 0, 0
0, 0, 0, 0, 0, 0, 0, 0, 0, 0, 0, 0, 0, 0, 0
-1, -1, 0
2, 0, 0, 2
4
0, 0, 0, 0, 0, 0, 0, 0, 0, 0, 0, 0, 0, 0, 0
0, 0, 0, 0, 0, 0, 0, 0, 0, 6, 6, 6, 6, 6, 6
0, 0, 0, 0, 0, 0, 0, 0, 0, 6, 0, 0, 0, 0, 0
0, 0, 0, 4, 0, 0, 0, 0, 0, 6, 0, 0, 0, 0, 0
0, 0, 0, 0, 0, 0, 0, 0, 0, 6, 0, 0, 0, 0, 0
0, 0, 0, 0, 0, 0, 0, 0, 0, 6, 6, 6, 6, 6, 6
0, 0, 0, 0, 0, 0, 0, 0, 0, 0, 0, 0, 0, 0, 0
0, -2, 0
0, 2, 2, 0
4
9, 9, 9, 9, 9, 9, 9, 9, 9, 9, 9, 9, 9, 9, 9
9, 0, 0, 0, 0, 0, 0, 0, 0, 6, 0, 0, 0, 0, 9
0, 0, 0, 0, 0, 0, 0, 0, 0, 6, 0, 0, 0, 0, 9
0, 0, 0, 0, 0, 0, 0, 0, 0, 6, 0, 5, 0, 0, 9
0, 0, 0, 0, 0, 0, 0, 0, 0, 6, 0, 0, 0, 0, 9
9, 0, 0, 0, 0, 0, 0, 0, 0, 6, 0, 0, 0, 0, 9
9, 9, 9, 9, 9, 9, 0, 0, 0, 9, 9, 9, 9, 9, 9
0, -1, 0
1, 2, 3, 0
4
0, 0, 0, 0, 0, 0, 0, 0, 0, 0, 0, 0, 0, 0, 0
0, 0, 0, 0, 0, 0, 0, 0, 0, 0, 0, 0, 0, 0, 0
0, 0, 0, 0, 0, 0, 0, 1, 0, 0, 0, 0, 0, 0, 0
0, 0, 0, 0, 0, 0, 1, 0, 0, 6, 0, 0, 0, 0, 0
0, 0, 0, 0, 0, 0, 0, 1, 0, 0, 0, 0, 0, 0, 0
0, 0, 0, 0, 0, 0, 0, 0, 0, 0, 0, 0, 0, 0, 0
0, 0, 0, 0, 0, 0, 0, 0, 0, 0, 0, 0, 0, 0, 0
0, 0, 0
2, 2, 3, 2
4
12, 0, 0, 0, 0, 0, 0, 0, 0, 0, 0, 0, 0, 0, 12
0, 0, 1, 0, 0, 1, 0, 0, 0, 1, 0, 0, 1, 0, 0
0, 0, 0, 0, 0, 0, 0, 0, 0, 0, 0, 0, 0, 0, 0
0, 0, 1, 0, 0, 1, 0, 4, 0, 1, 0, 0, 1, 0, 0
0, 0, 0, 0, 0, 0, 0, 0, 0, 0, 0, 0, 0, 0, 0
0, 0, 1, 0, 0, 1, 0, 0, 0, 1, 0, 0, 1, 0, 0
12, 0, 0, 0, 0, 0, 0, 0, 0, 0, 0, 0, 0, 0, 12
