16
-2, -3, 0
2, 2, 2, 2, 0, 0, 2, 2, 2, 2, 2, 2
4
9, 9, 9, 9, 9, 9, 6, 0, 0, 0, 0, 0, 0, 0, 0
9, 0, 0, 0, 0, 0, 6, 0, 0, 0, 0, 0, 0, 0, 0
9, 0, 0, 0, 0, 0, 6, 0, 0, 0, 0, 0, 0, 0, 1
9, 0, 0, 3, 0, 0, 6, 0, 0, 0, 0, 0, 0, 0, 1
9, 0, 0, 0, 0, 0, 6, 0, 0, 0, 0, 0, 0, 0, 1
9, 0, 0, 0, 0, 0, 6, 0, 0, 0, 0, 0, 0, 0, 0
9, 9, 9, 9, 9, 9, 6, 0, 0, 0, 0, 0, 0, 0, 0
-1, -3, 0
2, 0, 0, 0, 2, 2, 2, 2, 2, 0, 2, 2
4
0, 0, 0, 7, 0, 0, 0, 5, 0, 0, 0, 1, 0, 0, 0
0, 0, 0, 7, 0, 0, 0, 0, 0, 0, 0, 1, 0, 0, 0
1, 0, 0, 1, 1, 1, 1, 1, 1, 1, 1, 1, 0, 0, 0
1, 0, 0, 8, 0, 0, 0, 0, 0, 0, 0, 0, 0, 0, 0
1, 0, 0, 8, 1, 1, 1, 1, 1, 1, 1, 1, 0, 0, 0
0, 0, 0, 8, 0, 0, 0, 0, 0, 0, 0, 7, 0, 3, 0
0, 0, 0, 8, 0, 0, 0, 0, 0, 0, 0, 7, 0, 0, 0
-1, -2, 0
2, 2, 2, 0, 2, 2, 2, 2, 2, 4, 2, 2
4
0, 0, 0, 0, 0, 6, 0, 0, 0, 6, 0, 0, 0, 0, 0
0, 0, 0, 0, 0, 6, 0, 0, 0, 6, 0, 0, 0, 0, 0
0, 0, 1, 1, 0, 0, 0, 0, 0, 0, 0, 1, 1, 0, 0
0, 0, 1, 1, 0, 0, 0, 15, 0, 0, 0, 1, 1, 0, 0
0, 0, 1, 1, 0, 0, 0, 0, 0, 0, 0, 1, 1, 0, 0
9, 9, 0, 0, 0, 0, 0, 0, 0, 0, 0, 0, 0, 0, 0
9, 9, 9, 9, 9, 9, 0, 0, 0, 9, 9, 9, 9, 9, 9
-1, -1, 0
2, 2, 2, 1, 2, 2, 0, 2, 2, 2, 2, 2
4
1, 0, 0, 0, 0, 0, 0, 0, 0, 0, 0, 0, 0, 0, 1
0, 0, 0, 0, 0, 0, 0, 0, 0, 0, 0, 0, 0, 0, 0
0, 0, 0, 0, 0, 1, 0, 0, 0, 1, 0, 0, 0, 0, 0
0, 0, 0, 0, 0, 1, 0, 3, 0, 1, 0, 0, 0, 0, 0
0, 0, 0, 0, 0, 1, 0, 0, 0, 1, 0, 0, 0, 0, 0
0, 0, 0, 0, 0, 0, 0, 0, 0, 0, 0, 0, 0, 0, 0
1, 0, 0, 0, 0, 0, 0, 0, 0, 0, 0, 0, 0, 0, 1
-1, 0, 0
2, 2, 2, 0, 2, 2, 2, 2, 2, 2, 2, 2
4
9, 9, 9, 9, 9, 9, 9, 9, 9, 9, 9, 9, 9, 9, 9
9, 0, 0, 0, 0, 7, 0, 0, 0, 0, 0, 0, 0, 0, 9
9, 0, 0, 0, 0, 7, 0, 0, 0, 0, 0, 0, 0, 0, 0
9, 0, 14, 0, 0, 7, 0, 0, 0, 0, 0, 0, 0, 0, 0
9, 0, 0, 0, 0, 7, 0, 0, 0, 0, 0, 0, 0, 0, 0
9, 0, 0, 0, 0, 7, 0, 0, 0, 0, 0, 0, 0, 0, 9
9, 9, 9, 9, 9, 9, 9, 9, 9, 9, 9, 9, 9, 9, 9
0, -4, 0
2, 2, 2, 2, 2, 2, 2, 2, 2, 0, 2, 2
4
0, 0, 0, 0, 0, 8, 0, 0, 0, 7, 0, 0, 0, 0, 0
0, 0, 0, 0, 0, 8, 0, 0, 0, 7, 0, 0, 0, 0, 0
0, 0, 0, 0, 0, 8, 0, 0, 0, 7, 0, 0, 0, 0, 0
0, 0, 5, 0, 0, 8, 0, 0, 0, 7, 0, 0, 4, 0, 0
0, 0, 0, 0, 0, 8, 0, 0, 0, 7, 0, 0, 0, 0, 0
0, 0, 0, 0, 0, 8, 0, 0, 0, 7, 0, 0, 0, 0, 0
0, 0, 0, 0, 0, 8, 0, 0, 0, 7, 0, 0, 0, 0, 0
0, -3, 0
3, 2, 2, 3, 2, 2, 4, 2, 2, 0, 2, 2
4
1, 1, 1, 1, 1, 1, 0, 0, 0, 1, 1, 1, 1, 1, 1
1, 1, 1, 1, 1, 1, 0, 0, 0, 1, 1, 1, 1, 1, 1
0, 0, 0, 0, 0, 0, 1, 12, 1, 0, 0, 0, 0, 0, 0
0, 0, 0, 0, 0, 0, 12, 6, 12, 0, 0, 0, 0, 0, 0
0, 0, 0, 0, 0, 0, 1, 12, 1, 0, 0, 0, 0, 0, 0
1, 1, 1, 1, 1, 1, 0, 0, 0, 1, 1, 1, 1, 1, 1
1, 1, 1, 1, 1, 1, 0, 0, 0, 1, 1, 1, 1, 1, 1
0, -2, 0
0, 2, 2, 0, 2, 2, 0, 2, 2, 2, 2, 2
4
0, 0, 0, 0, 0, 0, 0, 0, 0, 0, 0, 0, 0, 0, 0
0, 0, 0, 15, 0, 0, 0, 0, 0, 0, 9, 6, 0, 0, 0
0, 0, 0, 0, 0, 0, 0, 0, 0, 0, 0, 0, 0, 0, 0
0, 0, 0, 0, 0, 0, 0, 0, 0, 0, 0, 0, 0, 0, 0
0, 0, 0, 0, 0, 0, 0, 0, 0, 0, 0, 0, 0, 0, 0
0, 0, 0, 1, 0, 0, 0, 0, 0, 0, 0, 5, 0, 0, 0
0, 0, 0, 0, 0, 0, 0, 0, 0, 0, 0, 0, 0, 0, 0
0, -1, 0
0, 2, 2, 3, 2, 2, 2, 2, 2, 0, 2, 2
4
0, 0, 0, 0, 0, 0, 0, 0, 0, 0, 0, 0, 0, 0, 15
0, 0, 0, 0, 0, 9, 0, 0, 0, 9, 0, 0, 0, 0, 0
0, 0, 0, 0, 0, 9, 0, 3, 0, 9, 0, 0, 0, 0, 0
0, 0, 0, 0, 0, 9, 0, 0, 0, 9, 0, 0, 0, 0, 0
0, 0, 0, 0, 0, 9, 9, 9, 9, 9, 0, 0, 0, 0, 0
0, 0, 0, 0, 0, 0, 0, 0, 0, 0, 0, 0, 0, 0, 0
13, 0, 0, 0, 0, 0, 0, 0, 0, 0, 0, 0, 0, 0, 13
0, 0, 0
0, 2, 2, 2, 2, 2, 0, 2, 2, 2, 2, 2
4
13, 0, 0, 0, 0, 0, 0, 0, 0, 0, 0, 0, 0, 0, 13
0, 1, 0, 0, 1, 0, 0, 0, 0, 0, 1, 0, 0, 1, 0
0, 0, 0, 0, 0, 0, 0, 0, 0, 0, 0, 0, 0, 0, 0
0, 1, 0, 0, 1, 0, 0, 0, 0, 0, 1, 0, 0, 1, 0
0, 0, 0, 0, 0, 0, 0, 0, 0, 0, 0, 0, 0, 0, 0
0, 1, 0, 0, 1, 0, 0, 0, 0, 0, 1, 0, 0, 1, 0
13, 0, 0, 0, 0, 0, 0, 0, 0, 0, 0, 0, 0, 0, 13
1, -3, 0
0, 2, 2, 2, 0, 0, 2, 2, 2, 2, 2, 2
4
0, 0, 0, 6, 0, 0, 0, 6, 0, 0, 0, 6, 0, 0, 0
6, 0, 6, 0, 0, 0, 6, 0, 6, 0, 0, 0, 6, 0, 0
0, 6, 0, 6, 0, 6, 0, 0, 0, 6, 0, 6, 0, 6, 0
0, 0, 6, 0, 6, 0, 0, 0, 0, 0, 6, 0, 6, 0, 0
0, 6, 0, 6, 0, 6, 0, 0, 0, 6, 0, 6, 0, 6, 0
6, 0, 6, 0, 0, 0, 6, 0, 6, 0, 0, 0, 6, 0, 0
0, 0, 0, 6, 0, 0, 0, 6, 0, 0, 0, 6, 0, 0, 0
1, -2, 0
0, 2, 2, 2, 2, 2, 2, 2, 2, 2, 2, 2
4
0, 0, 0, 0, 0, 8, 0, 0, 0, 0, 0, 0, 0, 0, 0
0, 0, 0, 0, 0, 8, 0, 0, 0, 0, 0, 0, 0, 0, 0
0, 0, 0, 0, 0, 8, 0, 0, 0, 0, 0, 0, 0, 0, 0
0, 0, 0, 0, 0, 8, 0, 0, 0, 0, 0, 0, 3, 0, 0
0, 0, 0, 0, 0, 8, 0, 0, 0, 0, 0, 0, 0, 0, 0
0, 0, 0, 0, 0, 8, 0, 0, 0, 0, 0, 0, 0, 0, 0
0, 0, 0, 0, 0, 8, 0, 0, 0, 0, 0, 0, 0, 0, 0
1, -1, 0
0, 2, 2, 2, 2, 2, 0, 2, 2, 2, 2, 2
4
9, 0, 0, 0, 0, 13, 0, 0, 0, 13, 0, 0, 0, 0, 0
9, 0, 0, 0, 0, 0, 0, 0, 0, 0, 0, 0, 0, 0, 0
0, 0, 0, 0, 0, 0, 0, 0, 0, 0, 0, 0, 0, 0, 0
0, 0, 0, 0, 0, 0, 0, 0, 0, 0, 0, 0, 0, 0, 0
0, 0, 0, 0, 0, 0, 0, 0, 0, 0, 0, 0, 0, 0, 0
9, 0, 0, 0, 0, 1, 0, 0, 0, 1, 0, 0, 0, 0, 0
9, 0, 0, 0, 0, 0, 0, 0, 0, 0, 0, 0, 0, 0, 0
2, -5, 0
2, 2, 2, 2, 2, 2, 2, 2, 2, 0, 2, 2
4
0, 0, 0, 0, 0, 0, 0, 0, 0, 0, 0, 0, 0, 0, 0
0, 1, 1, 1, 1, 1, 1, 1, 1, 1, 1, 1, 1, 1, 0
0, 1, 0, 0, 0, 1, 0, 0, 0, 1, 0, 0, 0, 1, 0
0, 1, 0, 0, 1, 0, 0, 2, 0, 0, 1, 0, 0, 1, 0
0, 1, 0, 0, 0, 0, 0, 0, 0, 0, 0, 0, 0, 1, 0
0, 1, 1, 1, 1, 1, 0, 0, 0, 1, 1, 1, 1, 1, 0
0, 0, 0, 0, 0, 0, 0, 0, 0, 0, 0, 0, 0, 0, 0
2, -4, 0
2, 2, 2, 2, 2, 2, 0, 2, 2, 0, 2, 2
4
0, 0, 0, 0, 7, 0, 0, 0, 0, 0, 1, 0, 0, 0, 0
0, 0, 0, 0, 7, 1, 1, 1, 1, 1, 1, 0, 3, 0, 0
0, 0, 0, 0, 7, 0, 0, 0, 0, 0, 1, 0, 0, 0, 0
1, 1, 1, 1, 9, 0, 0, 0, 0, 0, 9, 6, 6, 6, 6
0, 0, 0, 0, 8, 0, 0, 0, 0, 0, 8, 0, 0, 0, 0
0, 0, 0, 0, 7, 1, 1, 1, 1, 1, 8, 0, 0, 0, 0
0, 0, 0, 0, 7, 0, 0, 0, 0, 0, 8, 0, 0, 0, 0
2, -3, 0
2, 0, 0, 2, 2, 2, 3, 2, 2, 2, 2, 2
4
0, 7, 0, 0, 0, 8, 0, 0, 0, 0, 7, 0, 0, 0, 0
0, 7, 0, 0, 0, 8, 0, 0, 0, 0, 7, 0, 0, 0, 0
0, 7, 0, 0, 0, 8, 0, 0, 0, 0, 7, 0, 0, 0, 0
1, 1, 6, 6, 6, 1, 6, 6, 6, 1, 1, 9, 6, 6, 6
0, 8, 0, 0, 0, 7, 0, 0, 0, 0, 6, 0, 0, 0, 0
0, 8, 0, 0, 0, 7, 0, 0, 0, 0, 6, 0, 0, 0, 0
0, 8, 0, 0, 0, 7, 0, 0, 0, 0, 6, 0, 0, 0, 3
